###################
#......###........#
#.##.#.###.#.##.#.#
#...............#.#
#.##.#.###.#.##.#.#
#..#.....#...#....#
##.###.#.#.###.####
 #.#   #.....#.#
##.# ####### #.####
.....#     #.......
###################
